cluster	growth-rate	color
Hoyosella_altamirensis.fasta	Outgroup	Outgroup	black
M_abscessus_bolletii.fasta	M. abscessus-cholonae complex	Rapid	red
M_abscessus_massiliense.fasta	M. abscessus-cholonae complex	Rapid	red
M_abscessus.fasta	M. abscessus-cholonae complex	Rapid	red
M_immunogenum.fasta	M. abscessus-cholonae complex	Rapid	red
M_franklinii.fasta	M. abscessus-cholonae complex	Rapid	red
M_saopaulense.fasta	M. abscessus-cholonae complex	Rapid	red
M_salmoniphilum.fasta	M. abscessus-cholonae complex	Rapid	red
M_chelonae.fasta	M. abscessus-cholonae complex	Rapid	red
M_stephanolepidis.fasta	M. abscessus-cholonae complex	Rapid	red
M_smegmatis.fasta	M. fortuitum-smegmatis group	Rapid	orange
M_goodii.fasta	M. fortuitum-smegmatis group	Rapid	orange
M_wolinskyi.fasta	M. fortuitum-smegmatis group	Rapid	orange
M_mageritense.fasta	M. fortuitum-smegmatis group	Rapid	orange
M_brisbanense.fasta	M. fortuitum-smegmatis group	Rapid	orange
M_aquaticum.fasta	M. fortuitum-smegmatis group	Rapid	orange
M_houstonense.fasta	M. fortuitum-smegmatis group	Rapid	orange
M_setense.fasta	M. fortuitum-smegmatis group	Rapid	orange
M_peregrinum.fasta	M. fortuitum-smegmatis group	Rapid	orange
M_fortuitum_fortuitum.fasta	M. fortuitum-smegmatis group	Rapid	orange
M_senegalense.fasta	M. fortuitum-smegmatis group	Rapid	orange
M_conceptionense.fasta	M. fortuitum-smegmatis group	Rapid	orange
M_farcinogenes.fasta	M. fortuitum-smegmatis group	Rapid	orange
M_septicum.fasta	M. fortuitum-smegmatis group	Rapid	orange
M_neworleansense.fasta	M. fortuitum-smegmatis group	Rapid	orange
M_porcinum.fasta	M. fortuitum-smegmatis group	Rapid	orange
M_hodleri.fasta	Special	Rapid	pink
M_boenickei.fasta	Special	Rapid	pink
M_nonchromogenicus.fasta	M. terrae	Slow	springgreen3
M_heraklionensis.fasta	M. terrae	Slow	springgreen3
M_longobardus.fasta	M. terrae	Slow	springgreen3
M_hiberniae.fasta	M. terrae	Slow	springgreen3
M_engbaekii.fasta	M. terrae	Slow	springgreen3
M_minnesotensis.fasta	M. terrae	Slow	springgreen3
M_arupensis.fasta	M. terrae	Slow	springgreen3
M_terrae.fasta	M. terrae	Slow	springgreen3
M_kumamotonensis.fasta	M. terrae	Slow	springgreen3
M_senuensis.fasta	M. terrae	Slow	springgreen3
M_algericus.fasta	M. terrae	Slow	springgreen3
M_celatum.fasta	M. celatum group	Slow	gold1
M_branderi.fasta	M. celatum group	Slow	gold1
M_kyorinense.fasta	M. celatum group	Slow	gold1
M_fragae.fasta	M. celatum group	Slow	gold1
M_shimoidei.fasta	M. celatum group	Slow	gold1
M_noviomagense.fasta	M. xenopi group	Slow	purple
M_heckeshornense.fasta	M. xenopi group	Slow	purple
M_xenopi.fasta	M. xenopi group	Slow	purple
M_ulcerans.fasta	pathogens group	Slow	deepskyblue
M_pseudoshottsii.fasta	pathogens group	Slow	deepskyblue
M_marinum_Europe.fasta	pathogens group	Slow	deepskyblue
M_intermedium.fasta	pathogens group	Slow	deepskyblue
M_gordonae.fasta	pathogens group	Slow	deepskyblue
M_asiaticum.fasta	pathogens group	Slow	deepskyblue
M_kubicae.fasta	pathogens group	Slow	deepskyblue
M_shinjukuense.fasta	pathogens group	Slow	deepskyblue
M_lacus.fasta	pathogens group	Slow	deepskyblue
M_tuberculosis.fasta	pathogens group	Slow	deepskyblue
M_decipiens.fasta	pathogens group	Slow	deepskyblue
M_riyadhense.fasta	pathogens group	Slow	deepskyblue
M_szulgai.fasta	pathogens group	Slow	deepskyblue
M_angelicum.fasta	pathogens group	Slow	deepskyblue
M_gastri.fasta	pathogens group	Slow	deepskyblue
M_persicum.fasta	pathogens group	Slow	deepskyblue
M_kansasii.fasta	pathogens group	Slow	deepskyblue
M_triplex.fasta	M. simiae complex	Slow	tan4
M_genavense.fasta	M. simiae complex	Slow	tan4
M_florentinum.fasta	M. simiae complex	Slow	tan4
M_lentiflavum.fasta	M. simiae complex	Slow	tan4
M_simiae.fasta	M. simiae complex	Slow	tan4
M_sherrisii.fasta	M. simiae complex	Slow	tan4
M_chimaera.fasta	M. avium complex	Slow	gray
M_intracellulare_yongonense.fasta	M. avium complex	Slow	gray
M_intracellulare.fasta	M. avium complex	Slow	gray
M_paraintracellulare.fasta	M. avium complex	Slow	gray
M_marseillense.fasta	M. avium complex	Slow	gray
M_avium_avium.fasta	M. avium complex	Slow	gray
M_bouchedurhonense.fasta	M. avium complex	Slow	gray
M_timonense.fasta	M. avium complex	Slow	gray
M_arosiense.fasta	M. avium complex	Slow	gray
M_mantenii.fasta	M. avium complex	Slow	gray
M_colombiense.fasta	M. avium complex	Slow	gray
M_vulneris.fasta	M. avium complex	Slow	gray
M_europaeum.fasta	Ungrouped	Slow	darkslategray
M_paraseoulense.fasta	Ungrouped	Slow	darkslategray
M_nebraskense.fasta	Ungrouped	Slow	darkslategray
M_parascrofulaceum.fasta	Ungrouped	Slow	darkslategray
M_scrofulaceum.fasta	Ungrouped	Slow	darkslategray
M_palustre.fasta	Ungrouped	Slow	darkslategray
M_heidelbergense.fasta	Ungrouped	Slow	darkslategray
M_malmoense.fasta	Ungrouped	Slow	darkslategray
M_alsense.fasta	Ungrouped	Slow	darkslategray
M_interjectum.fasta	Ungrouped	Slow	darkslategray
M_paraense.fasta	Ungrouped	Slow	darkslategray
M_parmense.fasta	Ungrouped	Slow	darkslategray
M_bohemicum.fasta	Ungrouped	Slow	darkslategray
M_saskatchewanense.fasta	Ungrouped	Slow	darkslategray
M_conspicuum.fasta	Ungrouped	Slow	darkslategray
M_talmoniae.fasta	Ungrouped	Slow	darkslategray
M_haemophilum.fasta	Ungrouped	Slow	darkslategray
M_leprae.fasta	Ungrouped	Slow	darkslategray
M_lepromatosis.fasta	Ungrouped	Slow	darkslategray
M_brumae.fasta	Ungrouped	Rapid	darkslategray
M_celeriflavum.fasta	Ungrouped	Rapid	darkslategray
M_mucogenicum.fasta	Ungrouped	Rapid	darkslategray
M_vanbaalenii.fasta	Ungrouped	Rapid	darkslategray
M_pyrenivorans.fasta	Ungrouped	Rapid	darkslategray
M_austroafricanum.fasta	Ungrouped	Rapid	darkslategray
M_pallens.fasta	Ungrouped	Rapid	darkslategray
M_neoaurum.fasta	Ungrouped	Rapid	darkslategray
M_malmesburii.fasta	Ungrouped	Rapid	darkslategray
M_duvalii.fasta	Ungrouped	Rapid	darkslategray
M_koreensis.fasta	Ungrouped	Rapid	darkslategray
M_aromaticivorans.fasta	Ungrouped	Rapid	darkslategray
M_rutilum.fasta	Ungrouped	Rapid	darkslategray
M_thermoresistibile.fasta	Ungrouped	Rapid	darkslategray
M_chlorophenolicum.fasta	Ungrouped	Rapid	darkslategray
M_vaccae.fasta	Ungrouped	Rapid	darkslategray
M_obuense.fasta	Ungrouped	Rapid	darkslategray
M_trivialis.fasta	Ungrouped	Rapid	darkslategray
M_hassiacum.fasta	Ungrouped	Rapid	darkslategray
M_monacense.fasta	Ungrouped	Rapid	darkslategray
M_cosmeticum.fasta	Ungrouped	Rapid	darkslategray
M_holsaticum.fasta	Ungrouped	Rapid	darkslategray
M_gilvum_Spyr1.fasta	Ungrouped	Rapid	darkslategray
M_rufum.fasta	Ungrouped	Rapid	darkslategray
M_agri.fasta	Ungrouped	Rapid	darkslategray
M_iranicum.fasta	Ungrouped	Rapid	darkslategray
M_fluoranthenivorans.fasta	Ungrouped	Rapid	darkslategray
M_aurum.fasta	Ungrouped	Rapid	darkslategray
M_insubricum.fasta	Ungrouped	Rapid	darkslategray
M_llatzerense.fasta	Ungrouped	Rapid	darkslategray
M_chubuense.fasta	Ungrouped	Rapid	darkslategray
M_elephantis.fasta	Ungrouped	Rapid	darkslategray
M_canariasense.fasta	Ungrouped	Rapid	darkslategray
M_confluentis.fasta	Ungrouped	Rapid	darkslategray
M_crocinum.fasta	Ungrouped	Rapid	darkslategray
M_sphagni.fasta	Ungrouped	Rapid	darkslategray
M_litorale.fasta	Ungrouped	Rapid	darkslategray
M_bacteremicum.fasta	Ungrouped	Rapid	darkslategray
M_grossiae.fasta	Ungrouped	Rapid	darkslategray
M_doricum.fasta	Ungrouped	Rapid	darkslategray
M_novocastrense.fasta	Ungrouped	Rapid	darkslategray
M_diernhoferi.fasta	Ungrouped	Rapid	darkslategray
M_parafortuitum.fasta	Ungrouped	Rapid	darkslategray
M_moriokaense.fasta	Ungrouped	Rapid	darkslategray
M_phlei.fasta	Ungrouped	Rapid	darkslategray
M_rhodesiae.fasta	Ungrouped	Rapid	darkslategray
M_tusciae.fasta	Ungrouped	Rapid	darkslategray
M_fallax.fasta	Ungrouped	Rapid	darkslategray